10.ox
..........
...........
.oo.......
..........
..........
..o.......
..........
..........
..........
o......o..