10.ox
..........
..........
.oo.......
..........
....z.....
..o.......
..........
..........
..........
o......o..